{
    
  "title": "Level Eleven",
  "tiles" : [ [1, 0, 1, 0, 1, 1, 1, 0, 1 ],
              [1, 1, 1, 1, 1, 1, 1, 1, 1],
              [1, 1, 1, 1, 1, 1, 0, 1, 1 ],
              [1, 1, 1, 1, 1, 1, 1, 1, 1 ],
              [0, 1, 1, 1, 1, 1, 1, 1, 0 ],
              [1, 1, 1, 1, 1, 1, 1, 1, 1 ],
              [1, 0, 1, 1, 1, 1, 1, 0, 1 ],
              [1, 0, 1, 1, 1, 1, 1, 0, 1 ],
              [0, 0, 1, 0, 0, 0, 1, 0, 0 ] ],

  "targetScore" : 1100,
  "moves" : 11,
}
